W,W,W,W,W,W,W,W,W/
W,E,E,E,E,E,E,E,w/
w,e,w,w,w,w,w,w,w/
W,E,E,E,E,E,E,E,w/
W,E,E,E,E,E,E,E,w/
W,E,E,E,E,E,E,E,w/
w,e,w,w,w,w,w,w,w/
W,E,E,E,E,E,E,E,w/
w,w,w,w,w,w,w,w,w/