9,9
null
null
0
W,W,W,W,W,W,W,W,W
W,E:P1,E,E,E,E,E,E,W
W,E,E,E,E,E,W,E,W
W,E,E,E,E,E,W,E,W
W,E:SLE,E,E,E,E,W,E,W
W,E,E,E,E,E,W,E,W
W,E,E,E,E,E,W,E,W
W,E,E,E,E,E:SLE,W,E:SLE,W
W,W,W,W,W,W,W,W,W