7,7
null
null
0
W,W,W,W,W,W,W
W,E:P1,E:FL,E:FB,E,E,W
W,WA,WA,F,F,E,W
W,E,E,E,E,G,W
W,E,E,E,E,E,W
W,E,E,E,E,E,W
W,W,W,W,W,W,