13,13
null
null
0
W,W,W,W,W,W,W,W,W,W,W,W,W
W,E:P1,E,E:TK,E:TK,E:TK,E:TK,E:TK,E,E,E,E,W
W,E,TP:5-5,E,E,TP:2-5,E,E,E,E,E,E,W
W,E,E,E,E,E,E,E,E,E,E,E,W
W,E,E,E,E,E,E,E,E,E,E,E,W
W,E,TP:5-2,E,E,TP:2-2,E,E,E,E,E,E,W
W,E,E,E,E,E,E,E,E,E,E,E,W
W,CDR,W,E,E:RK,E,E,E,E:BK,E,E,E,W
W,G,W,E,E,E,E,E,E,E,E:GK,E,W
W,W,W,W,CDG,W,CDB,W,TDR,W,TDR,W,W
W,E,E,E,E,E,E,E,E,E,E,E,W
W,E,E,E,E,E,E,E,E,E,E,E,W
W,W,W,W,W,W,W,W,W,W,W,W,W