20,20
null
null
0
W,W,W,W,W,W,W,W,W,W,W,W,W,W,W,W,W,W,W,W
W,W,W,E,E,E,W,W,W,W,W,E,E,E,E,E,E,E,E,W
W,W,W,E,E,E,E,W,W,E,E:WFE,E,E,E,E,E,E,E,E,W
W,E,E,E,E,E,E,E,E,E,E,E,E,E,E,E:WFE,E,E,E,W
W,E,E,E,E,E,E,E,E,E,E,E,E,E,E,W,E,E,E,W
W,E,E,E,E,E,E:WFE,E,E,E,W,E,E,E,E,E,E,E,E,W
W,W,E,E,E,W,W,W,W,W,W,W,W,E,E,E,E,E,E,W
W,W,W,E,E,W,E,E,E,E,E,E,W,W,W,E,E,E,E,W
W,W,W,E,E,W,E,E,E,E,E,E,W,E,E,E,E,E,E,W
W,W,E,E,E,W,E,E,E,E:WFE,E,E,W,E,E,E,E,E,E,W
W,E,E,E,E,W,E,E,F,F,E,E,W,W,W,E,E,E,W,W
W,E,E,E,E,W,E,E,E,E,E,E,W,E,E,E,E,W,W,W
W,E,E,E,E,W,E,E,E,E,E,E,W,E,E,E,E,W,W,W
W,E,E,E,E,W,W,W,W,W,W,W,W,E,E,E,E,E,W,W
W,E,E,E,E,E,E,E,W,E,E,W,E,E,E,E,E,E,E,W
W,E,E,E,E,E,E,E,E,E,E,E,E,E,E,E,E,E,E,W
W,E,E,E,E,E,E,E,E,E,E,E,E,E,E,I,I,CDB,W,W
W,E,E,E,E,E,E,E,W,W,W,E,E,E,E,CDG,E,E,E,W
W,E,E,E,E,E,E,W,W,W,W,W,E,E,E,CDG,E,E:P1,E,W
W,W,W,W,W,W,W,W,W,W,W,W,W,W,W,W,W,W,W,W