15,13
null
null
0
W,W,W,W,W,W,W,W,W,W,W,W,W,W,W
W,E:P1,E,E,W,W,W,E,E,E,E,E,E,E,W
W,E,E:L,E:L,E,E,W,E:SLE,E,E,W,CDB,W,E:FL,W
W,E,E,E:TK,E,E,W,E,E:TK,E:RK,W,E,W,E:L,W
W,E,E,E,E,E,W,F,F,F,W,CDR,W,W,W
W,E,E,E:FB,E,E,E,E:BK,E,WA,E,E,E,E,W
W,E:TK,E,E,E,E,E,E,E,WA,E,E,E,E,W
W,W,W,W,W,W,W,W,W,E:IS,E,E,E,E,W
W,WA,WA,E:SLE,E,E,E,E,E,E,E,E,E,E,W
W,E:TK,WA,E,E:L,E,W,TDR,W,E,E,E,E,E,W
W,WA,WA,E,E,E,W,E,W,E,E,E:TK,E,E,W
W,E:TK,I,I,I,I,W,G,W,E,E,E,E,E,W
W,W,W,W,W,W,W,W,W,W,W,W,W,W,W
