10,10
null
null
0
W,W,W,W,W,W,W,W,W,W
W,E:P1,E,E,E,E,E,F,E,W
W,TP:5-5,E,E,E,F,E,E,E,W
W,W,E,E,E,E,E,F,E,W
W,W,E,E,E,E,E,E,E,W
W,W,E,E,E,TP:2-1,E,E,E,W
W,E,E,E,E,E,E,E,E,W
W,CDR,W,E,E:RK,E,E:P2,E,E,W
W,G,W,E,E,E,E,E,E,W
W,W,W,W,W,W,W,W,W,W