9,9
null
null
0
W,W,W,W,W,W,W,W,W
W,E:P1,E,E,W,E,E,E,W
W,E,E,E,W,E,E:STE,E,W
W,E,E,E,W,E,E,E,W
W,W,W,E,W,W,W,W,W
W,E,E,E,E,E,E,E,W
W,E,E,E,E,E,E,E,W
W,E:STE,E,E,E,E,E,E,W
W,W,W,W,W,W,W,W,W