15,15
W,W,W,W,W,W,W,W,W,W,W,W,W,W,W
W,W,W,E:P,E,E:TK,E,E,E,E,E,E,W,W,W
W,W,W,E,E,E:SLE,E,E,E,E,E,E,W,W,W
W,W,W,E,E,E,E,E,E,E,E,E,W,W,W
W,W,W,E,E,E,E,E,E,E,E,E,W,W,W
W,W,W,E,E,E,E,E,E,E,E,E,W,W,W
W,W,W,E,E,E,E,E,E,E,E,E,W,W,W
W,W,W,E,E,E,E,E,E,E,E,E,W,W,W
W,W,W,E,E,E,E,E,E,E,E,E,W,W,W
W,W,W,E,E,E,E,E,E,E,E,E,W,W,W
W,W,W,E,E,E,E,E,E,E,E,E,W,W,W
W,W,W,E,I,I,I,I,I,I,I,E,W,W,W
W,W,W,E,F,F,F,F,F,F,F,E,W,W,W
W,W,W,E,E,E,E,E,E,E,E,E,W,W,W
W,W,W,W,W,W,W,W,W,W,W,W,W,W,W