15,15
W,W,W,W,W,W,W,W,W,W,W,W,W,W,W
W,W,W,E:P,E,E:TK,E,E,E,E,E,E,W,W,W
W,W,W,E,TP:10-7,E:SLE,E,E,E,E,E,E,W,W,W
W,W,W,E,E,E,E,E,E,E,E,E,W,W,W
W,W,W,E,E,E,E,E,E,E,E,E,W,W,W
W,W,W,E,E,E,E,E,E,E,E,E,W,W,W
W,W,W,E,E,E,E,E,E,E,E,E,W,W,W
W,W,W,E,E,E,E,E:TK,E,E,TP:4-2,E,W,W,W
W,W,W,E,E,E,E,E,E,E,E,E,W,W,W
W,W,W,E,E,E,E,E,E,E,E,E,W,W,W
W,W,W,E,E,E,E,E,E,E,E,E,W,W,W
W,W,W,E,I,I,I,I,I,I,I,E,W,W,W
W,W,W,E,F,F,F,F,F,F,F,E,W,W,W
W,W,W,E,E,E,E,E,E,E,E,E,W,W,W
W,W,W,W,W,W,W,W,W,W,W,W,W,W,W