13,13
TK:1, RK:0, GK:0, BK:0, FB:0, FL:0, IS:0, L:0
null
17
W,W,W,W,W,W,W,W,W,W,W,W,W
W,E,E,E,E:TK,E:TK,E:TK,E:TK,E,E,E,E,W
W,E,TP:5-5,E,E,TP:2-5,E,E,E,E,E,E,W
W,E,E,E,E,E,E,E,E,E,E,E,W
W,E,E,E,E,E,E,E,E,E,E,E,W
W,E,TP:5-2,E,E:P1,TP:2-2,E,E,E,E,E,E,W
W,E,E,E,E,E,E,E,E,E,E,E,W
W,CDR,W,E,E:RK,E,E,E,E:BK,E,E,E,W
W,G,W,E,E,E,E,E,E,E,E:GK,E,W
W,W,W,W,CDG,W,CDB,W,TDR,W,TDR,W,W
W,E,E,E,E,E,E,E,E,E,E,E,W
W,E,E,E,E,E,E,E,E,E,E,E,W
W,W,W,W,W,W,W,W,W,W,W,W,W
